5 5 5 5 5 0 0 5 5 5 5 5 5 5 5 5 5 5 5 5 5 5 5 5 5 5 5 5 5 5
5 5 5 5 5 0 0 5 5 5 5 5 5 5 5 5 5 5 5 5 5 5 3 3 3 3 3 3 1 1
5 5 5 5 5 0 0 5 5 5 5 5 5 5 5 5 5 5 5 5 5 5 3 3 3 3 3 1 1 1
5 5 5 5 5 0 0 0 0 0 0 0 0 0 0 5 5 5 5 5 5 5 3 3 3 3 1 1 1 1
5 5 5 5 5 0 0 0 0 0 0 0 0 0 0 5 5 5 5 5 5 5 3 3 3 1 1 1 1 1
5 5 5 5 5 0 0 0 0 0 0 0 0 0 0 5 5 5 5 5 5 5 3 3 1 1 1 1 1 1
0 0 0 0 0 0 0 0 0 0 0 0 0 0 0 0 0 0 0 0 0 0 3 3 1 1 1 1 1 1
0 0 0 0 0 0 0 0 0 0 0 0 0 0 0 0 0 0 0 0 0 0 3 3 1 1 1 1 1 1
5 5 5 5 5 0 0 0 0 0 0 0 0 0 0 5 5 5 5 5 5 5 3 3 1 1 1 1 1 1
5 5 5 5 5 0 0 0 0 0 0 0 0 0 0 5 5 5 5 5 5 5 3 3 3 1 1 1 1 1
5 5 5 5 5 0 0 0 0 0 0 0 0 0 0 5 5 5 5 5 5 5 3 3 3 3 1 1 1 1
5 5 5 5 5 5 0 0 5 5 5 5 5 5 5 5 5 5 5 5 5 5 3 3 3 3 3 1 1 1
5 5 5 5 5 5 0 0 5 5 5 5 5 5 5 5 5 5 5 5 5 5 3 3 3 3 3 3 1 1
5 5 5 5 5 5 0 0 5 5 5 5 5 5 5 5 5 5 5 5 5 5 5 5 5 5 5 5 5 5
5 5 5 5 5 5 0 0 5 5 5 5 5 5 5 5 5 5 5 5 5 5 5 5 5 5 5 5 5 5